{
  "map": [
    [2, 2, 2, 2, 2, 2, 2, 2, 2, 2, 2, 2, 2, 2, 2, 2, 2, 2, 2, 2, 2],
    [2, 0, 0, 0, 0, 1, 2, 1, 1, 1, 2, 1, 1, 1, 2, 1, 0, 0, 0, 0, 2],
    [2, 2, 2, 2, 2, 1, 1, 1, 2, 1, 1, 1, 2, 1, 1, 1, 2, 2, 2, 2, 2],
    [2, 0, 0, 0, 0, 1, 2, 1, 1, 1, 2, 1, 1, 1, 2, 1, 0, 0, 0, 0, 2],
    [2, 2, 2, 2, 2, 1, 1, 1, 2, 1, 1, 1, 2, 1, 1, 1, 2, 2, 2, 2, 2],
    [2, 0, 0, 0, 0, 1, 2, 1, 1, 1, 2, 1, 1, 1, 2, 1, 0, 0, 0, 0, 2],
    [2, 2, 2, 2, 2, 1, 1, 1, 2, 1, 1, 1, 2, 1, 1, 1, 2, 2, 2, 2, 2],
    [2, 0, 0, 0, 0, 1, 2, 1, 1, 1, 2, 1, 1, 1, 2, 1, 0, 0, 0, 0, 2],
    [2, 2, 2, 2, 2, 1, 1, 1, 2, 1, 1, 1, 2, 1, 1, 1, 2, 2, 2, 2, 2],
    [2, 0, 0, 0, 0, 1, 2, 1, 1, 1, 2, 1, 1, 1, 2, 1, 0, 0, 0, 0, 2],
    [2, 2, 2, 2, 2, 2, 2, 2, 2, 2, 2, 2, 2, 2, 2, 2, 2, 2, 2, 2, 2]
  ],
  "spawns": [
    {"x": 1, "y": 1},
    {"x": 1, "y": 3},
    {"x": 1, "y": 5},
    {"x": 1, "y": 7},
    {"x": 1, "y": 9},
    {"x": 19, "y": 9},
    {"x": 19, "y": 7},
    {"x": 19, "y": 5},
    {"x": 19, "y": 3},
    {"x": 19, "y": 1}
  ]
}