{
  "map": [
    [2, 2, 2, 2, 2, 2, 2, 2, 2, 2, 2, 2, 2],
    [2, 0, 0, 2, 2, 2, 0, 2, 2, 2, 0, 0, 2],
    [2, 0, 0, 0, 2, 0, 0, 0, 2, 0, 0, 0, 2],
    [2, 2, 0, 0, 0, 1, 0, 0, 1, 0, 0, 2, 2],
    [2, 2, 2, 1, 0, 1, 1, 0, 0, 0, 2, 2, 2],
    [2, 2, 0, 1, 0, 1, 0, 0, 1, 1, 0, 2, 2],
    [2, 0, 0, 0, 0, 1, 0, 1, 1, 1, 0, 2, 2],
    [2, 2, 0, 1, 0, 1, 0, 0, 0, 0, 0, 2, 2],
    [2, 2, 2, 1, 0, 0, 0, 1, 1, 1, 2, 2, 2],
    [2, 2, 0, 1, 1, 1, 0, 1, 1, 1, 0, 2, 2],
    [2, 0, 0, 0, 0, 0, 0, 1, 0, 0, 0, 0, 2],
    [2, 2, 0, 1, 0, 1, 0, 0, 0, 1, 0, 2, 2],
    [2, 2, 2, 1, 0, 1, 0, 1, 0, 0, 2, 2, 2],
    [2, 2, 0, 0, 0, 1, 0, 1, 1, 0, 0, 2, 2],
    [2, 0, 0, 0, 2, 0, 0, 0, 2, 0, 0, 0, 2],
    [2, 0, 0, 2, 2, 2, 0, 2, 2, 2, 0, 0, 2],
    [2, 2, 2, 2, 2, 2, 2, 2, 2, 2, 2, 2, 2]
  ],
  "spawns": [
    {"x": 6, "y": 2},
    {"x": 6, "y": 14},
    {"x": 2, "y": 6},
    {"x": 2, "y": 10},
    {"x": 10, "y": 10},
    {"x": 10, "y": 6},
    {"x": 2, "y": 14},
    {"x": 10, "y": 14},
    {"x": 2, "y": 2},
    {"x": 10, "y": 2}
  ]
}