{
  "map": [
    [2, 2, 2, 2, 2, 2, 2, 2, 2, 2, 2, 2, 2, 2, 2, 2, 2, 2, 2, 2, 2],
    [2, 0, 0, 0, 0, 0, 2, 0, 0, 0, 2, 0, 0, 0, 2, 0, 0, 0, 0, 0, 2],
    [2, 1, 1, 1, 1, 0, 1, 0, 2, 0, 1, 0, 2, 0, 1, 0, 1, 1, 1, 1, 2],
    [2, 1, 1, 1, 1, 1, 2, 0, 0, 0, 2, 0, 0, 0, 2, 1, 1, 1, 1, 1, 2],
    [2, 1, 1, 1, 1, 0, 1, 0, 1, 0, 1, 0, 1, 0, 1, 0, 1, 1, 1, 1, 2],
    [2, 0, 0, 0, 0, 0, 2, 0, 1, 0, 2, 0, 1, 0, 2, 0, 0, 0, 0, 0, 2],
    [2, 1, 1, 1, 1, 0, 1, 0, 1, 0, 1, 0, 1, 0, 1, 0, 1, 1, 1, 1, 2],
    [2, 1, 1, 1, 1, 1, 2, 0, 0, 0, 2, 0, 0, 0, 2, 1, 1, 1, 1, 1, 2],
    [2, 1, 1, 1, 1, 0, 1, 0, 2, 0, 1, 0, 2, 0, 1, 0, 1, 1, 1, 1, 2],
    [2, 0, 0, 0, 0, 0, 2, 0, 0, 0, 2, 0, 0, 0, 2, 0, 0, 0, 0, 0, 2],
    [2, 2, 2, 2, 2, 2, 2, 2, 2, 2, 2, 2, 2, 2, 2, 2, 2, 2, 2, 2, 2]
  ],
  "spawns": [
    {"x": 1, "y": 1},
    {"x": 19, "y": 1},
    {"x": 1, "y": 5},
    {"x": 1, "y": 9},
    {"x": 8, "y": 1},
    {"x": 12, "y": 1},
    {"x": 19, "y": 9},
    {"x": 19, "y": 5},
    {"x": 8, "y": 9},
    {"x": 12, "y": 9}
  ]
}